111111111111111111
11010001000C001001
100101010100100001
100001E00100000001
10P000000000000001
100100100001001101
110010000010000101
111E00111011100101
100001000001000001
100C000C00C0000001
100101011101100101
100000000000000001
100000000000000001
11010001000C00P001
1P100P011110101011
111111111111111111
